N:sample_map03
S:23,17
T:100
D:2,2,2,2,0,0,0,0,0,0,0,0,0,0,0,0,0,0,0,2,2,2,2
D:2,2,2,2,0,0,0,0,0,0,0,0,0,0,0,0,0,0,0,2,2,2,2
D:2,2,2,2,0,0,3,0,3,0,0,0,0,0,3,0,3,0,0,2,2,2,2
D:2,2,2,2,0,0,0,3,0,0,0,0,0,0,0,3,0,0,0,2,2,2,2
D:2,2,2,2,0,0,0,0,2,0,0,0,0,0,2,0,0,0,0,2,2,2,2
D:2,2,2,2,0,0,0,0,0,2,0,0,0,2,0,0,0,0,0,2,2,2,2
D:2,2,2,2,0,0,0,0,2,2,2,2,2,2,2,0,0,0,0,2,2,2,2
D:2,2,2,2,0,0,0,2,2,0,2,2,2,0,2,2,0,0,0,2,2,2,2
D:2,2,2,2,0,0,2,2,2,2,2,2,2,2,2,2,2,0,0,2,2,2,2
D:2,2,2,2,0,0,2,0,2,2,2,2,2,2,2,0,2,0,0,2,2,2,2
D:2,2,2,2,0,0,2,0,2,3,3,3,3,3,2,0,2,0,0,2,2,2,2
D:2,2,2,2,0,0,3,0,0,2,2,3,2,2,0,0,3,0,0,2,2,2,2
D:2,2,2,2,0,0,3,0,0,0,0,3,0,0,0,0,3,0,0,2,2,2,2
D:2,2,2,2,0,0,3,0,0,0,0,3,0,0,0,0,3,0,0,2,2,2,2
D:2,2,2,2,0,0,3,0,0,0,0,3,0,0,0,0,3,0,0,2,2,2,2
D:2,2,2,2,0,0,3,0,0,0,0,3,0,0,0,0,3,0,0,2,2,2,2
D:2,2,2,2,0,0,0,0,0,0,0,0,0,0,0,0,0,0,0,2,2,2,2
H:17,6
C:5,6