N:sample_map02
S:23,17
T:100
D:2,2,2,2,0,0,0,0,0,0,0,0,0,0,0,0,0,0,0,2,2,2,2
D:2,2,2,2,0,0,0,0,0,0,0,0,0,0,0,0,0,0,0,2,2,2,2
D:2,2,2,2,0,0,0,0,0,3,0,0,0,3,0,0,0,0,0,2,2,2,2
D:2,2,2,2,0,0,0,3,0,0,3,0,3,0,0,3,0,0,0,2,2,2,2
D:2,2,2,2,0,0,3,0,3,0,2,3,2,0,3,0,3,0,0,2,2,2,2
D:2,2,2,2,0,3,0,3,0,3,0,0,0,3,0,3,0,3,0,2,2,2,2
D:2,2,2,2,0,0,3,0,2,0,3,0,3,0,2,0,3,0,0,2,2,2,2
D:2,2,2,2,0,3,0,3,0,3,0,2,0,3,0,3,0,3,0,2,2,2,2
D:2,2,2,2,0,0,3,0,2,0,3,0,3,0,2,0,3,0,0,2,2,2,2
D:2,2,2,2,0,3,0,3,0,3,0,0,0,3,0,3,0,3,0,2,2,2,2
D:2,2,2,2,0,0,3,0,3,2,0,3,0,2,3,0,3,0,0,2,2,2,2
D:2,2,2,2,0,0,0,3,0,0,3,2,3,0,0,3,0,0,0,2,2,2,2
D:2,2,2,2,0,0,0,0,0,3,0,2,0,3,0,0,0,0,0,2,2,2,2
D:2,2,2,2,0,0,0,0,0,0,0,2,0,0,0,0,0,0,0,2,2,2,2
D:2,2,2,2,0,0,0,0,0,0,0,2,0,0,0,0,0,0,0,2,2,2,2
D:2,2,2,2,0,0,0,0,0,0,0,2,0,0,0,0,0,0,0,2,2,2,2
D:2,2,2,2,0,0,0,0,0,0,2,0,2,0,0,0,0,0,0,2,2,2,2
H:17,16
C:5,16