N:sample_map01
S:23,17
T:150
D:2,2,2,2,0,0,0,0,0,0,0,0,2,2,2,0,3,0,0,2,2,2,2
D:2,2,2,2,0,0,2,0,0,0,0,0,0,2,0,0,0,3,0,2,2,2,2
D:2,2,2,2,0,0,2,0,0,0,0,0,0,0,0,0,0,0,3,2,2,2,2
D:2,2,2,2,0,2,2,0,0,0,0,0,0,0,0,2,2,0,0,2,2,2,2
D:2,2,2,2,0,0,0,3,0,0,0,0,0,0,3,0,2,0,0,2,2,2,2
D:2,2,2,2,0,0,0,2,3,0,0,0,0,0,0,2,2,0,0,2,2,2,2
D:2,2,2,2,2,0,0,2,2,3,0,0,0,0,0,0,0,0,0,2,2,2,2
D:2,2,2,2,2,0,0,0,2,0,2,2,2,0,0,0,0,0,2,2,2,2,2
D:2,2,2,2,2,0,0,0,0,0,2,2,2,0,0,0,0,0,2,2,2,2,2
D:2,2,2,2,2,0,0,0,0,0,2,2,2,0,2,0,0,0,2,2,2,2,2
D:2,2,2,2,0,0,0,0,0,0,0,0,0,3,2,2,0,0,2,2,2,2,2
D:2,2,2,2,0,0,2,2,0,0,0,0,0,0,3,2,0,0,0,2,2,2,2
D:2,2,2,2,0,0,2,0,3,0,0,0,0,0,0,3,0,0,0,2,2,2,2
D:2,2,2,2,0,0,2,2,0,0,0,0,0,0,0,0,2,2,0,2,2,2,2
D:2,2,2,2,3,0,0,0,0,0,0,0,0,0,0,0,2,0,0,2,2,2,2
D:2,2,2,2,0,3,0,0,0,2,0,0,0,0,0,0,2,0,0,2,2,2,2
D:2,2,2,2,0,0,3,0,2,2,2,0,0,0,0,0,0,0,0,2,2,2,2
H:18,16
C:4,0